NO      Textures/image.png
SO      Textures/image.png
WE      Textures/image.png
EA      Textures/player.png         

F 040,040,040
C 180,180,180

111111111111111111111111111111111
1E0000000000000000110000000000001
100000001011000001110000000000001
100000001001000000000000000000001
111111111011000001110000000000001
100000000011000001110111111111111
111101111111110111000000100000001
111101111111110111010100100000001
110000001101010111000000100000001
100000000000000011000000000000001
100000000000000011010100000000001
110000011101010111110111001000111
11110111 1110101 1011110100000001
11111111 1111111 1111111111111111