NO      Textures/bob.png
WE      Textures/braz.png
SO      Textures/lava.png
EA      Textures/fire.png

F 180,180,180
C 080,080,080

111111111111111111111111111111111
100000000000000001100000000000001
100000001000000011100000000000001
10000000100100000D000000000000001
111111111011000001110000000000001
100000000011000001110111111111111
111101111111110111000000100000001
11110111111111D111010100100000001
110000001101010111000000100000001
10000000000000N011000000000000001
100000000000000011010100000000001
110000011101010111110111001000111
11110111 1110101 1011110100000001
11111111 1111111 1111111111111111