NO      Textures/image.png
SO      Textures/image.png
WE      Textures/image.png
EA      Textures/player.png

C 060,060,080
F 020,020,020

1111111111111111111111111
1000000000000000000000001
1000000100000000011000001
1000000001000011000000001
1000000000000E00000000001
1000000100000000010000001
1000000000000000000000001
1111111111111111111111111
