11111111
1000N001
10000001
10000001
10000001
10000001
10000001
10000001
10000001
10010001
10001001
10000001
10000001
10010001
10010001
10010001
11111111